XXXXXXXXXXXXXXXXXXXXXXXXXXXXXXXXXXXXXXXXXXXXXXXXXXXXXXXXXXXXXXX
X                                                             X
X                                                             X
X                                                             X
X       +----------------------+                              X
X       |......................|                              X
X       |.+------------------+.|                              X
X       |.|                  |.|                              X
X       |.|                  |.|                              X
X       |.|                  |.|                              X
X       |.|                  |.|                              X
X       |.+------------------+.+----------------+             X
X       |......*................................|             X
X       +--------------+.+--------------------+.|             X
X                      |.|                    |.|             X
X                      |.|                    |.|             X
X                      |.|                    |.|             X
X                      |.|                    |.|             X
X                      |.|                    |.|             X
X                      |.|                    |.|             X
X                      |.+--------------------+.|             X
X                      |...............G........|             X
X                      +------------------------+             X
X                                                             X
X                                                             X
X                                                             X
X                                                             X
XXXXXXXXXXXXXXXXXXXXXXXXXXXXXXXXXXXXXXXXXXXXXXXXXXXXXXXXXXXXXXX
